32
22
0l----0l----0l----0l----0l----0l----0l----0l----0l----0l----0l----0l----0l----0l----0l----0l----0l----0l----0l----0l----0l----0l----0l----0l----0l----0l----0l----0l----0l----0l----0l----0l----
0l----0l----0l----0l----0l----0l----0l----0m----0m----0m----0l----0l----0l----0l----0l----0l----0l----0l----0l----0m----0l----0m----0l----0l----0l----0l----0l----0l----0l----0l----0l----0l----
0l----0l----0m----0l----0l----0l----0l----0m----0m----0m----0m----0m----0l----0m----0m----0m----0m----0l----0l----0l----0m----0m--0a0m----0m----0l----0l----0m----0m----0m----0l----0m----0m----
0m----0m----0l----0l----0l----0l----0l----0l----0m----0m----0m----0m----0l----0m----0m----0j----0m----0m----0l----0m----0m----0f----0m----0l----0l----0m----0m----0m----0l----0m----0l----0m----
0m----0m----0m----0m----0m----0m--0a0m----0m----0m----0m----0j----0j--0x0m----0j----0j----0j----0j----0m----0m----0m----0m----0f----0f----0f----0m----0m----0j----0j----0m----0m----0l----0m----
0j----0j----0m----0m----0m----0m----0m----0m----0m----0m----0j----0j----0j----0j----0j----0j----0j----0j----0m----0m----0m----0m----0f----0n----0m----0j----0j----0j----0m----0m----0m----0m----
0j----0j----0j----0j----0m----0m----0m----0m----0m----0j----0j----0j----0j----0j----0j----0j--0g0j----0j----0j----0j----0m----0j----0m----0n----0m----0j----0j--0x0j----0j----0j----0m----0m----
0n----0n----0j--0g0n----0j----0j----0j----0j--0g0j----0j----0j----0n----0j----0n----0j----0n----0n----0n----0n02--0n----0j----0j----0j----0j----0n----0n----0j----0j----0j----0j----0j----0j----
0n----0n----0n----0n----0j----0n----0j----0n----0j----0n----0n----0n----0n----0n----0n----0n----0n----0n----0n----0n----0n----0n----0j----0j----0j----0j----0n----0j----0j----0j----0j----0o----
0n----0n04--0n----0n----0n----0n----0n----0n----0n----0n----0n----0n----0n----0n----0n----0n----0n----0n----0n----0n----0n----0n----0j----0n----0j----0n----0n----0n----0n----0n----0o----0o----
0n----0n----0n----0n----0n----0n----07----07----07----0n----0n----0n----0n----0n----0n----0n----0n----0n----0n----0n----0n----0n----0n----0n----0n----0n----0n----0n----0n----0n----0o----0o----
0n----07----0n----0n----0n----0n----07----07----0n----07----07----0n----0n----0n----0n----0f----0n----0f----0n02--0n----0n----0n----0n----0n----0n----0n----0n----0n----0n----0n--0r0o----0o----
07----07----07----07----07----07----07----07----07----07----0n----0n----0n----07----0f----07----0f----0f----0f----0n----0n----0n----0n----0n----0n----0n----0n----0n----0n----0o----0o----0o----
07----07----07----07----07----07----07----07----07----07----07----07----07----07----07----07----07----0f----0f----0n----0n----0n----0n----0n----0n----0n----0n----0n----0o----0o----0o----0o----
07----070a--07----07----07--0n07----07----07----07----07----07----07----07----07----07----07----07----0f----0n----0n----0n----0n----0n----0n----0n----0n----0n----0n--0l0f----0f----0o----0o----
07----07----07----07--0n07----0503--07----07----07--0207----07----07----07----07----07----07----0n----0n----0n----0n----0n----0n----0n----0n----0n----0n----0n06--0f----0f----0f----0n----0o----
07----07----07----07----07----07----07--0n07----07----07----07--0n07----07----07----07----0n----0n----0n----0n----0n----0n----0n----0n----0n----0n----0n----0n----0n----0n----0f----0f----0o----
07----07----07----0501--07----07----07----07----0701--07----07----07----07----0n----0n----0n----0n----0n----0n----0n----0n----0n----0n----0n----0n----0n----0n----0n00--0f----0o----0o----0o----
07----07----05----07----07----07----07----07----07----07----07----0n----0n----0n----0n----0n----0n----0n----0n----0n----0n----0n----0n----0n08--0n0b--0n----0n--0l0o----0o----0o----0o----0o----
07----05----05----07----07--0707----07----07----07----07----07----07----0n----0n----0n----0n----0n----0n----0n----0n----0n----0n----0n----0n----0n--0l0o----0o----0o----0o----0o----0o----0o----
05----07----07----07--0n07----07----0n--0807----07----07--0n07----07----07----07----0n----0n----0n----0n----0n----0n----0n----0n----0n----0o----0o----0o----0o----0o----0o----0o----0o----0o----
07----07----07----07----07----07----07----07----07----07----07----07----07----07----0n----0n----0n----0n----0n----0n----0n----0n----0n----0n----0o----0o----0o----0o----0o----0o----0o----0o----
