00000eee0000ee000000000000ee00
00000ee00000ee000000000000ee00
000eee000000ee0e00000000000eee
0000e0000000eeee000000000000ee
000000000000eee0eee000000000ee
0000000e0000ee0000ee00000000ee
000eeee00000ee0000eeee000000ee
0ee0e0000000e0000000ee00000000
e0000000000ee00000000000000000
000000000e0ee00000e00000000900
0000000eeee000000ee00000000099
00000000e00000000ee000000ee099
0000ee0000000e000ee0000eeee000
000eee000000ee0eee00000eee0000
0eeeee00000eeeee0000000eee0000