32
17
0101010101010101010101010101010101010101010101010101000000000000
01000000010001010101010i0i0i0i0i0i000101010101010101010000000000
0100000000000001010100000i0i0i0d00000001010101000100010000000000
010100000000000101000000000i000d0d000000010101000000000000000000
01010101000000000000000i0i00000000000000010100000000000000000000
010101010100000000000i000000000000000000000100000000000000000000
01010101000000000000000000000000000i0000000000000000000000000000
010101000000000i000000000000000i0i0i0i0i000i00000000000000090000
0101000000000i0i0i000000000i0i00000000000i0i000i0000000000000909
01010d0d00000i0i0i000000000i000000010000000i0i0i0i00000000000909
01010101000i0i00000000000i0i00000d0d0d0000000i000000000000000000
010101010i00000000000000000i000000000d00000i0i000000000000000000
010101010i0000000000000000000i0i000i000i0i0i00000000000000000000
010i0i0i0i0000000001010000000i0i0i000i000i0000000000000000000000
0i0000000000000001010101000i0i0000000000000000000001000000000000
0000000000000000010101010000000000000000000000000001010000000000
0000000000010101010101010101010101010101010101010100010000000000
