00000fff0000ff000000000000ff00
00000ff00000ff000000000000ff00
000fff000000ff0f00000000000fff
0000f0000000ffff000000000000ff
000000000000fff0fff000000000ff
0000000f0000ff0000ff00000000ff
000ffff00000ff0000ffff000000ff
0ff0f0000000f0000000ff00000000
f0000000000ff00000000000000000
000000000f0ff00000f00000000900
0000000ffff000000ff00000000099
00000000f00000000ff000000ff099
0000ff0000000f000ff0000ffff000
000fff000000ff0fff00000fff0000
0fffff00000fffff0000000fff0000