44444444444444444444444444444444
44444442224444444444444444444444
22422222222444466666444666666444
22222226264546666666666g6g666644
22222266655666666666666ggg666666
55666g65566666666666666666666666
66556555556666666666666666666668
6666566655556668668866686668688a
666868886855bb88688888888668aaae
688888888888bbbb88888888888aaeee
88888888888888bbbb88888aa8aaeeee
8888888888888888bbbb88a8a8a8eeee
8888c888jj8j888888bb88888j8j88e8
jjjj8888jjjj888888bb8888jjjjj888
jjjjjj8jjjjjjjjj88bb888jjjjjjjjj
jjjjjjjjjkjjjkjjjjbbjjjjjjjjjjjj
jjjkkkkkkkkkk0kkjkbbjkjkjjjjjjjk
jkk0000kkk000000k0bbk0k0kkjjjjjk
k0000000k00000000000000000kkjkjk
0000000kk0000000000000000000k0k0
00000kk0000000000000000000000000
0000kkd00000000i0000000000000000
0000kkd000000ii0i000011111110000
000000k00000iii00000011111100000
000000k0000000i00000111110000000
0000000000000ii00000111000000000
0000000000000i000000000000000000
0000000000000i000000000000000000
