000000000000000000000000000000
000000000000000000000000000000
222222222222222222222220000000
000000000000000000000000000000
000000000000000000000000000000
000022222222222222222222222222
000000000000000000000000000000
000000000000000000000000000000
000000000000000000000000000000
222222222222222222222222200000
000000000000000000000000000000
000000000000000000000000000000
000000000000000000000000000000
000000000000000000000000000000
000000000222222222222222200000