111111111111111111111111111111
111111111111111111111111111111
111111111111111111111111111111
111111111111111111111111111111
111111111111111111111111111111
111111111111111111111111111111
222222222222200222222222222222
222222222222200222222222222222
000000000000000000000000000000
000000000000000000000000000000
000000000000000000000000000000
000000000000000000000000000000
000000000000000000000000000000
002000000000022222200000000000
002200000000000000000000000000
022200000000000000000000000000
002000000000000000000220000000
000000000000000000000220000000
000000000220000000000200000000
000000000220000000000000000000
000000000000000000000000000000
000000000000000000000000000000
000000000000000020000000000000
000000000000020000022000000000
000000000000000000000000000000
000000000000000000000000000000