222222222222222222222222222222
222222222228289928282222282228
288828888888889998888888888888
888888888888889998888888888888
888888888888889998888888888888
888888888888889998888888888888
888888888888889998888888888888
8d8888888d888899988d88888d888d
dddddddddddddd999ddddd8ddddddd
dddddddddddddd9990d0ddddd0dddd
000000e000000099900000d0000000
00000ee00000000000000000000000
0000eee00000000000000000000000
0000eeeee000000000000000000000
000ee0e0e000000000000ee0000000
00000000000000000e0eee00000000
00000e00000000000eeee000000000
0000eee000000000eee00000000000
0000eee00000000000000000000000
000000000000000000000000000000
00000000000000000000000eeee000
0000000000000000000000eee0e000
000000000000000000000eeeeee000
ee0000000000000000000000e0e000
eeee00000000000000000000000000
eeee00000000000000000000000000