111111111111111111111111111111
111122111111111212111111111111
111121111111111222111111111111
111122111111111111111111111111
111111111111111111111111111111
111111111111111111111111111111
111111111111111111111221111111
111111111111111111111221111111
111111111111111111111211111111
111111111111111111111111111111
111122111111111111111111111111
111122211111111111111111111111
111122211111111111111111111111
111111111111111111111111111111
111111111111111111111111111111
111122111111111111111111111111
111122211111111111111111111111
111122211111111111111111111111
111111111111111111111111111111
111111111111111111111111111111