666666666666666666776666666666
676666666666677766777666677666
777766676667777777776666777666
555777677777757575766667666667
555575755555555555777777777777
225555555555525225557577777777
222222222222222225555555557575
222222222222222222525555555555
222222222222222222222254555454
222222222222222222222244444445
222222222222222222222333424555
222222222222222222233332222222
222222252222222223333222222222
222225555522222333322222222222
222255555222223332222222222222
222255555222223322222222222222
222222522222223322222222222222
222222222222223322225555552222
222222222222223322225555552222
222222222222223322222255522222