32
28
0404040404040404040404040404040404040404040404040404040404040404
0404040404040402020204040404040404040404040404040404040404040404
0202040202020202020202040404040606060606040404060606060606040404
02020202020202060206040504060606060606060606060g060g060606060404
02020202020206060605050606060606060606060606060g0g0g060606060606
05050606060g0605050606060606060606060606060606060606060606060606
0606050506050505050506060606060606060606060606060606060606060608
060606060506060605050505060606080606080806060608060606080608080a
0606060806080808060805050b0b08080608080808080808080606080a0a0a0e
0608080808080808080808080b0b0b0b08080808080808080808080a0a0e0e0e
08080808080808080808080808080b0b0b0b08080808080a0a080a0a0e0e0e0e
080808080808080808080808080808080b0b0b0b08080a080a080a080e0e0e0e
080808080c0808080j0j080j0808080808080b0b08080808080j080j08080e08
0j0j0j0j080808080j0j0j0j0808080808080b0b080808080j0j0j0j0j080808
0j0j0j0j0j0j080j0j0j0j0j0j0j0j0j08080b0b0808080j0j0j0j0j0j0j0j0j
0j0j0j0j0j0j0j0j0j0k0j0j0j0k0j0j0j0j0b0b0j0j0j0j0j0j0j0j0j0j0j0j
0j0j0j0k0k0k0k0k0k0k0k0k0k000k0k0j0k0b0b0j0k0j0k0j0j0j0j0j0j0j0k
0j0k0k000000000k0k0k0000000000000k000b0b0k000k000k0k0j0j0j0j0j0k
0k000000000000000k00000000000000000000000000000000000k0k0j0k0j0k
000000000000000k0k000000000000000000000000000000000000000k000k00
00000000000k0k00000000000000000000000000000000000000000000000000
000000000k0k0d00000000000000000i00000000000000000000000000000000
000000000k0k0d0000000000000i0i000i000000000101010101010100000000
0000000000000k00000000000i0i0i0000000000000101010101010000000000
0000000000000k000000000000000i0000000000010101010100000000000000
000000000000000000000000000i0i0000000000010101000000000000000000
000000000000000000000000000i000000000000000000000000000000000000
000000000000000000000000000i000000000000000000000000000000000000
