32
22
0l0l0l0l0l0l0l0l0l0l0l0l0l0l0l0l0l0l0l0l0l0l0l0l0l0l0l0l0l0l0l0l
0l0l0l0l0l0l0l0m0m0m0l0l0l0l0l0l0l0l0l0m0l0m0l0l0l0l0l0l0l0l0l0l
0l0l0m0l0l0l0l0m0m0m0m0m0l0m0m0m0m0l0l0l0m0m0m0m0l0l0m0m0m0l0m0m
0m0m0l0l0l0l0l0l0m0m0m0m0l0m0m0j0m0m0l0m0m0f0m0l0l0m0m0m0l0m0l0m
0m0m0m0m0m0m0m0m0m0m0j0j0m0j0j0j0j0m0m0m0m0f0f0f0m0m0j0j0m0m0l0m
0j0j0m0m0m0m0m0m0m0m0j0j0j0j0j0j0j0j0m0m0m0m0f0n0m0j0j0j0m0m0m0m
0j0j0j0j0m0m0m0m0m0j0j0j0j0j0j0j0j0j0j0j0m0j0m0n0m0j0j0j0j0j0m0m
0n0n0j0n0j0j0j0j0j0j0j0n0j0n0j0n0n0n0n0n0j0j0j0j0n0n0j0j0j0j0j0j
0n0n0n0n0j0n0j0n0j0n0n0n0n0n0n0n0n0n0n0n0n0n0j0j0j0j0n0j0j0j0j0o
0n0n0n0n0n0n0n0n0n0n0n0n0n0n0n0n0n0n0n0n0n0n0j0n0j0n0n0n0n0n0o0o
0n0n0n0n0n0n0707070n0n0n0n0n0n0n0n0n0n0n0n0n0n0n0n0n0n0n0n0n0o0o
0n070n0n0n0n07070n07070n0n0n0n0f0n0f0n0n0n0n0n0n0n0n0n0n0n0n0o0o
070707070707070707070n0n0n070f070f0f0f0n0n0n0n0n0n0n0n0n0n0o0o0o
07070707070707070707070707070707070f0f0n0n0n0n0n0n0n0n0n0o0o0o0o
07070707070707070707070707070707070f0n0n0n0n0n0n0n0n0n0n0f0f0o0o
070707070705070707070707070707070n0n0n0n0n0n0n0n0n0n0n0f0f0f0n0o
0707070707070707070707070707070n0n0n0n0n0n0n0n0n0n0n0n0n0n0f0f0o
070707050707070707070707070n0n0n0n0n0n0n0n0n0n0n0n0n0n0n0f0o0o0o
07070507070707070707070n0n0n0n0n0n0n0n0n0n0n0n0n0n0n0n0o0o0o0o0o
0705050707070707070707070n0n0n0n0n0n0n0n0n0n0n0n0n0o0o0o0o0o0o0o
0507070707070n070707070707070n0n0n0n0n0n0n0n0n0o0o0o0o0o0o0o0o0o
07070707070707070707070707070n0n0n0n0n0n0n0n0n0n0o0o0o0o0o0o0o0o
