000004440000440000000000004400
000004400000440000000000004400
000444000000440400000000000444
000040000000444400000000000044
000000000000444044400000000044
000000040000440000440000000044
000444400000440000444400000044
044040000000400000004400000000
400000000004400000000000000000
000000000404400000400000000300
000000044440000004400000000033
000000004000000004400000044033
000044000000040004400004444000
000444000000440444000004440000
044444000004444400000004440000