222222222222222222222222222222
222222222228289928282222282228
288828888888889998888888888888
888888888888889998888888888888
888888888888889998888888888888
888888888888889998888888888888
888888888888889998888888888888
8e8888888e888899988e88888e888e
eeeeeeeeeeeeee999eeeee8eeeeeee
eeeeeeeeeeeeee9990e0eeeee0eeee
000000f000000099900000e0000000
00000ff00000000000000000000000
0000fff00000000000000000000000
0000fffff000000000000000000000
000ff0f0f000000000000ff0000000
00000000000000000f0fff00000000
00000f00000000000ffff000000000
0000fff000000000fff00000000000
0000fff00000000000000000000000
000000000000000000000000000000
00000000000000000000000ffff000
0000000000000000000000fff0f000
000000000000000000000ffffff000
ff0000000000000000000000f0f000
ffff00000000000000000000000000
ffff00000000000000000000000000