32
17
01----01----01----01----01----01----01----01----01----01----01----01----01----01----01----01----01----01----01----01----01----01----01----01----01----01----00----00----00----00----00----00----
01----00----00----00----01----00----01----01----01----01----01----0i----0i----0i----0i----0i----0i----00----01----01----01----01----01----01----01----01----01----00----00----00----00----00----
01----00----00----00----00----00----00----01----01----01----00----00----0i----0i----0i----0d----00----00----00----01----01----01----01----00----01----00----01----00----00----00----00----00----
01----01----00----00----00----00----00----01----01----00----00----00----0002--0i----00----0d----0d----00----00----00--0j01----01----01----00----00----00----00----00----00--0100----00----00----
01----01----01----01----00----00----00----00----00----00----00----0i----0i----00----00----00----00----00----00----00----01----01----0007--00----00----00----00----00----00----00----00----00----
01----01----01----01----01----00----000e--00----00----00----0i----00----00----00----00----00----00----00----00----00----00----01----00----00----00----00----00----00----00----00----00----00----
01----01----01----01----00----00----00----0003--00----00----00----00----00----00----00----00----00----0i----00----00----00----00----00----00----00----00----00----00----00----00----00----00----
01----01----01----00----00----00----00----0i----00----00----00----00----00----00----00----0i----0i----0i----0i----0i----00----0i----00----00----00----00----00----00----0005--09----00----00----
01----01----00----00----00----00----0i----0i----0i----00----00----00----00----0i----0i----00----00----00----00----00----0i----0i----00----0i----00----00----00----00----00----00----09----09----
01----01----0d----0d----00----00----0i----0i----0i----00----00----00----00----0i----00----00----00----01----00----00----00----0i----0i----0i----0i----00----00----00----00----00----09----09----
01----01----01----01----00----0i----0i----00----00----00----00----00----0i----0i----00----00----0d----0d----0d----00----00----00----0i----0003--00----00----00----00----00----00----00----00----
01----01----01----01----0i----00----00----00----00----00----00----00----00----0i----00----00----00----00----0d----00----00----0i----0i----00----00----00----00----00----00----00----00----00----
01----01----01----01----0i----00----00----00----00----00----00----00----00----00----0i----0i----00----0i----00----0i----0i----0i----00----00----00----00----00----00----00----00----00----00----
01----0i----0i----0i----0i----00----00----00----00--0901----01----00----00----0004--0i----0i----0i----00----0i----00----0i----00----00----00----00----00----00----00----000a--00----00----00----
0i----00----00----00----000a--00----00----00----01----01----01----01----00----0i----0i----00----00----00----00----00----00----00----00----00----00----01----00----00----00----00----00----00----
00----00----00----00----00----00----00----00----01----01----01----01----00----00----00----00----00----00----00----00----00----00----00--0f00----00--0f01----01----00----00----00----00----00----
00----00----00----00----00----01----01----01----01----01----01----01----01----01----01----01----01----01----01----01----01----01----01----01----01----00----01----00----00----00----00----00----
