32
28
04----04----04----04----04----04----04----04----04----04----04----04----04----04----04----04----04----04----04----04----04----04----04----04----04----04----04----04----04----04----04----04----
04----04----04----04----04----04----04----02----02----02----04----04----04----04----04----04----04----04----04----04----04----04----04----04----04----04----04----04----04----04----04----04----
02----02----04----02----02----02----02----02----02----02----02----04----04----04----04----06----06----06----06----06----04----04----04----06----06--0h06--0h06----06----06----04----04----04----
02----02----02----02----02----02----02----06----02----06----04----05----04----06--0h0608--06--0w06----06----06----06----06----06----06----0g----06----0g----06----06----06----06----04----04----
02----02----02----02----02----02----06----06----060f--05----05----06----06--0h06----06----06----06----06----06----06----06----06----0601--0g----0g----0g----06----06----06----06----06----06----
05----05----06----06----06--0h0g----06----05--0d05----06----06----06----06----06----06----06----06----06----06----06----06----06----06----06----06----06----06----06----06----06----06----06----
06----06----05----05----06----05----05----05----05----05----06----06----06----06----06----06----06----06----06----06----06----06----06----06----06----06----06----06----06----06----06----08----
06----06----06----06----05----06----06----06----05----05----05----05----06----06----06----08----06----06----08----08----06----06----06----08----06----06----06----08----06----08----08----0a----
06----06----06----08----06----08----08----08----06----08----05----05----0b----0b----08----08----06----08----08----08----08----08----08----08----08----06----06----08----0a----0a----0a----0e----
06----08----08----08----08----08----08----08----08----08----08----08----0b----0b----0b----0b----08----0801--08----08----08----08----08----08----080d--08----08----0a----0a----0e----0e----0e----
08----08----08----08----08----08----08----08----08----08----08----08----08----08----0b----0b----0b----0b----08----08----08----08----08----0a----0a----08--0k0a----0a0b--0e----0e----0e----0e----
08----08----08----08----08----0806--08----08----08----08----08----08----08----08----08----08----0b----0b----0b----0b----08----08----0a----08----0a----08----0a----08----0e----0e----0e----0e----
08----08----08----08----0c----08----08----08----0j--0g0j----08----0j----08----08----08----08----08----08----0b----0b----08----08----08----08----08----0j----08----0j----08----08----0e----08----
0j----0j----0j----0j----08----08----08----08----0j----0j----0j----0j----08----08----08----08----08----08----0b----0b----08----08----08----08----0j----0j----0j----0j----0j----08--0y08----08----
0j----0j----0j----0j----0j----0j----08----0j----0j----0j----0j----0j----0j----0j----0j----0j----08----08----0b----0b09--08----08----08----0j----0j----0j----0j----0j----0j----0j----0j----0j----
0j----0j----0j----0j----0j----0j----0j----0j----0j----0k----0j----0j----0j----0k----0j----0j----0j----0j----0b09--0b----0j----0j----0j----0j----0j----0j----0j--0x0j----0j----0j----0j----0j----
0j----0j----0j----0k----0k----0k----0k----0k----0k----0k----0k----0k----0k----00----0k----0k----0j----0k----0b----0b----0j----0k----0j----0k----0j----0j----0j----0j--0x0j----0j----0j----0k----
0j----0k----0k----00----00----00--0f00----0k----0k----0k----00----00----00----00----00----00----0k----00----0b----0b----0k----00----0k----00----0k----0k----0j----0j----0j----0j----0j----0k----
0k----00----00----00--0f00----00--0600----00--0f0k----00----00----00----00----00----00----00----00----00----00----00----00----00----00----00----00----00----0k----0k----0j----0k----0j----0k----
00----00----00----00----00----00----00----0k----0k----00----00----00----00----00----00----00----00----00----00----00----00----00----00----00----00----00----00----00----0k----00----0k----00----
00----0005--00----00----000a--0k----0k----00----00----00----00----00----00----00----00----00----00----00----00----00----00----00----00----00----00----00----00----00----00----00----00----00----
00----00----00----00----0k----0k----0d----00----00----00----00----00----00----00----00----0i----00----00----00----00----00----00----000e--00----00----00----00----00----00----00----00----00----
00----00----00----00----0k----0k----0d----00----00----00----00----00----00----0i----0i----0003--0i----00----00----00----00----01----01----01----01----01----01----01----00----00----00----00----
00----00----00----00----00----00----0k----00----00----00----00----00----0i----0i----0i----00----00----00----00----00----00----01----01----01----01----01----01----00----00----00----00----00----
00----00----00----00----00----00----0k----00----00----00----00----00----0005--00----0i----00----00----00----00----00----01----01----01----01----01----00----00----00----00----00----00----00----
00----00----00----00----00----00----00----00----00----00----00----00----00----0i----0i----00----00----00----00----00----01----01----01----00----00----0004--00----00----00----00----00----00----
00----00----00----00----0004--00----00----00----00----00----00----00----00----0i----00----0007--00----00----00----00----00----00----00----00----00----00----00----00----00----00----00----00----
00----00----00----00----00----00----00----00----00----00----00----00----00----0i----00----00----00----00----00----00----00----00----00----00----00----00----00----00----00----00----00----00----
