32
17
11111111111111111111111111000000
10001011111iiiiii011111111100000
100000011100iiid0001111010100000
1100000110000i0dd000111000000000
11110000000ii0000000110000000000
1111100000i000000000010000000000
11110000000000000i00000000000000
1110000i0000000iiiii0i0000000900
110000iii0000ii00000ii0i00000099
11dd00iii0000i0001000iiii0000099
11110ii00000ii00ddd000i000000000
1111i00000000i0000d00ii000000000
1111i000000000ii0i0iii0000000000
1iiii000011000iii0i0i00000000000
i000000011110ii00000000001000000
00000000111100000000000001100000
00000111111111111111111110100000
