111111111111111111111111111111
111111111112123312121111121112
122212222222223332222222222222
222222222222223332222222222222
222222222222223332222222222222
222222222222223332222222222222
222222222222223332222222222222
252222222522223332252222252225
555555555555553335555525555555
555555555555553330505555505555
000000400000003330000050000000
000004400000000000000000000000
000044400000000000000000000000
000044444000000000000000000000
000440404000000000000440000000
000000000000000004044400000000
000004000000000004444000000000
000044400000000044400000000000
000044400000000000000000000000
000000000000000000000000000000
000000000000000000000004444000
000000000000000000000044404000
000000000000000000000444444000
440000000000000000000000404000
444400000000000000000000000000
444400000000000000000000000000